
-- Outpost PATH FIND/TRACK Nouns.

op.areas = {
	acklehigh = "Ackleberry Highway",
	acknor = "Village of Acknor",
	airplane = "Elemental Plane of Air",
	akhari = "Akhari Breeding Hive",
	alabaster = "Alabaster Road",
	amberle = "Pearl of the Amberle",
	angkrag = "Village of Angkrag",
	aquagoria = "Aquagoria",
	aquarius = "Astrosphere of Aquarius",
	arena = "Klangratch Tournies",
	aries = "Astrosphere of Aries",
	arysia = "Arysian Isles",
	asylum = "i'Xiia Asylum",
	avenger = "Avechna's Peak",
	balach = "Balach Swamp",
	blasted = "Blasted Lands",
	bondero = "Bondero Bay",
	bot1 = "Bottledowns",
	broadcasting = "Tainted Broadcast Centre",
	cancer = "Astrosphere of Cancer",
	cankermore = "Cankermore Battlegrounds",
	caoimhe = "Caoimhe Dell",
	capricorn = "Astrosphere of Capricorn",
	carai = "Carai Caroo",
	casino = "Divine Luck Club",
	catacombs = "Elemental Plane of Earth, Catacombs",
	cavalierbase = "The Base of the Cavaliers",
	celest = "City of New Celest",
	celestia = "Cosmic Plane of Celestia",
	chancel = "Chancel of Clangoran Mysteries",
	charune = "Temple of Charune",
	charune_realm = "Hunter's Woods",
	charune_temple = "Temple of Charune",
	clarramore = "Clarramore Cloud Gardens",
	climanti = "the City of Climanti",
	climantiruins = "the Ruined City of Climanti",
	cloadahi = "Cay of Cloadahi",
	cloudecho = "the Pancopticon of Lirangsha",
	cloudwalker = "Cloudwalker Settlement",
	coliseum = "Midnight Coliseum",
	continuum = "Cosmic Plane of the Continuum",
	crimsonlady = "Crimson Lady",
	crumkindivia = "Crumkindivia",
	crystal = "Crystal Meadows",
	cyaethl = "The Cyaethl Colonies",
	czigany = "Czigany Wayfaire",
	czixi_realm = "Czixi Realm",
	czixi_temple = "Temple of Czixi",
	dairuchi = "Village of Dairuchi",
	deathship = "Emperor's Glory",
	delport = "Village of Delport",
	despair = "Sea of Despair",
	displaced = "Displaced Wilds",
	djarrakh = "Ruins of Castle Djarrakh",
	domoth = "Realms of the Nine Domoth",
	dramube = "Dramube Triangle",
	dreamlake = "Elemental Plane of Water, Dream Lake",
	duum = "Village of Duum",
	elostian_realm = "Twilight Maelstrom",
	elostian_temple = "Temple of Elostian",
	emerald = "Emerald Road",
	emeraldenclave = "The Emerald Enclave",
	estelbar = "Village of Estelbar",
	estengare = "Estengare River",
	eternity = "Eternity Labs",
	ethglom = "Ethereal Glomdoring Forest",
	ethseren = "Ethereal Serenwilde Forest",
	facility = "Facility",
	faelabs = "The Secret Laboratories of Xeeth",
	faethorn = "Faethorn Realm",
	fain_realm = "Blood Fist",
	fain_temple = "Temple of Fain",
	fatehome = "(unnamed)",
	feyranti = "the Feyranti Estate",
	fireplane = "Elemental Plane of Fire",
	flesh = "Land of Flesh and Blood",
	frostfeather = "Frostfeather Grotto",
	frosticia = "Frosticia",
	fulcrux = "Transcendental Fulcrux",
	gardens = "Maeve Gardens",
	gaudiguch = "Gaudiguch City",
	gaudiguch_arena = "Pyrodome of the Kaleidoscopic Trials",
	gaudiguch_world = "Nexus World of Gaudiguch",
	gemini = "Astrosphere of Gemini",
	glade = "Glade of Champions",
	glomdoring = "Glomdoring Forest",
	gloriana = "Gloriana River",
	gourmetghetto = "Epicure's Alley",
	grandbazaar = "(unnamed)",
	greymoors = "Grey Moors",
	hajamin = "Floating Island of the Forgotten",
	hallifax = "Hallifax City",
	hallifax_arena = "the Skylark Commemorative Demiplane",
	hallifax_world = "Nexus World of Hallifax",
	hhuhur = "Caves of Hhuhur",
	hifarae = "Hifarae Hills",
	highwater = "Highwater Keep",
	hoaracle = "Living Dream",
	hoaracle_temple = "Temple of Hoaracle",
	hyfae = "Caverns of the Hyfae",
	iceplains = "Iceburn Plains",
	icetunnel = "Ice Havens",
	iklara = "Iklara",
	illteeth = "Illteeth Tunnels",
	illwater = "Illwater Lake",
	ilmdriarest = "Ilmdria's Rest",
	imhohet = "Imhohet Vats",
	improad = "Old Imperial Road",
	innersea = "Inner Sea",
	irshaw = "Irshaw Heights",
	isune_glade = "Glade of the Sleeping Goddess",
	isune_realm = "Ruins of Andeystelis",
	isune_temple = "Temple of Isune",
	ixthiaxa = "Village of Ixthiaxa",
	kelpiemaiden = "Kelpie Maiden",
	khementen = "Khementen Hive",
	krog = "Mount Krog",
	kryden = "Kryden Valik",
	leo = "Astrosphere of Leo",
	libra = "Astrosphere of Libra",
	lirangsha = "the Lirangsha Retreat",
	lisaera_realm = "Silver Weald",
	lisaera_temple = "Temple of Lisaera",
	lolliprin = "Land of Lolliprin",
	lyraa = "Lyraa Ey Rielys",
	madness = "Elemental Plane of Earth, Mountains",
	magnagora = "City of Magnagora",
	malacoda = "Malacoda Manor",
	manteekan = "Temple of Manteekan",
	manteekan_realm = "Everlasting Haze",
	manticorepeaks = "Southern Mountain Peaks",
	mastercomplex = "Master Complex",
	maylea_realm = "Kiunid Vruna",
	maylea_temple = "Temple of Maylea",
	mesa = "Lucidian Mesa Compound",
	moonbubble = "Manifestation of Mother Moon",
	morgfyre_realm = "Eternal Ouroboros",
	morgfyre_temple = "Temple of Morgfyre",
	mornhai = "Daeiv ma'Mornhai",
	mornlow = "Mornhai Sanctuary",
	mountdio = "Mount Dio",
	mountwend = "Mount Wend",
	mucklemarsh = "Mucklemarsh",
	muhanlesh = "Caverns of Muhanlesh",
	mumhatuti = "Mumhatuti Hive",
	mysrai = "Temple of Mysrai",
	mysrai_realm = "Shifting City",
	mysticriver = "Elemental Plane of Water, Mystic River",
	neferti = "Neferti Fungus Gardens",
	newbie_gloriana = "Gloriana Forest",
	newbie_itecia = "Isle to Itecia",
	newbie_malacoda = "Village of Malacoda",
	newbie_nyalia = "Isle of Nyalia",
	newton = "Newton Caverns",
	nexusworld_celest = "Nexus World of New Celest",
	nexusworld_glom = "Nexus World of Glomdoring",
	nexusworld_mag = "Nexus World of Magnagora",
	nexusworld_seren = "Nexus World of Serenwilde",
	nightbubble = "Manifestation of Mother Night",
	nightmarket = "The Night Market",
	["nil"] = "Cosmic Plane of Nil",
	nirvana = "Nirvana",
	nocht_realm = "Whispering Abyss",
	nocht_temple = "Temple of Nocht",
	nomads = "Dracnari Nomad Camp",
	northice = "Northern Icewynd Mountains",
	northmount = "Northern Mountains",
	northpass = "Northern Passages",
	observatory = "Arthar'rt Observatory",
	oleanvir = "Oleanvir Valley",
	olimsito = "the Isle of Olimsito",
	orphanage = "St. Gathlyn Orphanage",
	orrery = "Orrery",
	paavik = "Village of Paavik",
	pandaemonium = "Pandaemonium",
	pisces = "Astrosphere of Pisces",
	plaxios = "Plaxios Lowlands",
	presidio = "Presidio of the Damned",
	prison = "Great Illithoid Prison",
	ptoma = "Village of Ptoma",
	quake_alabaster = "Alabaster Road Construction Site",
	quake_ayridion = "Gardens of Ayridion",
	quake_balach = "Balach Observatory",
	quake_desolateage = "(unnamed)",
	quake_goloths = "Imperial Courtyards of the Goloths",
	quake_immaculateage = "(unnamed)",
	quake_kephera = "Kephera Slave Quarters",
	quake_museum = "Museum of Post-Empire Artifacts",
	quake_oldcelest = "Royal City of Old Celest",
	quake_paradox = "(unnamed)",
	quake_retirement = "Trader Bob's Retirement Home",
	quake_spires = "Spires of Glomborolum",
	quake_timedomoth = "(unnamed)",
	quake_toronada = "Bridge over Toronada Lava River",
	quake_twilight = "Twilight Pagoda of Gloriana Forest",
	quake_xyl = "Spires of Xyl",
	raezon_realm = "Forbidden Reach",
	raezon_temple = "Temple of Raezon",
	rashepera = "Rashepera Hive",
	razine = "Razine Mountains",
	razinetunnel = "Razine Tunnels",
	repository = "Meliashmora of Imperial Secrets",
	reserve = "Kiakodan Nature Reserve",
	rikenfriez = "Village of Rikenfriez",
	rockholm = "Village of Rockholm",
	rocpeaks = "Razine Peaks",
	sagittarius = "Astrosphere of Sagittarius",
	scorpio = "Astrosphere of Scorpio",
	scorpioncaves = "Scorpion Caverns",
	serenwilde_north = "Serenwilde Forest, North",
	serenwilde_south = "Serenwilde Forest, South",
	sethetmun = "Sethetmun Hive",
	sewers_celest = "Sewers of New Celest",
	sewers_magnagora = "Sewers of Magnagora",
	shadowvale = "Shadowvale Arena",
	shallach = "Ruins of Shallach",
	shallamar = "Shallamar, Realm of the Fates",
	shallamurine = "Shallamurine Cathedral",
	shalriver = "Shallach River",
	shanthmark = "Village of Shanthmark",
	shikari_realm = "Proving Grounds",
	shikari_temple = "Temple of Shikari",
	skarch = "Skarch Desert",
	smokecavern = "Caverns of Smoke Mountain",
	smoketop = "Top of Smoke Mountain",
	snowfeather = "Snowfeather Caverns",
	snowvalley = "Snow Valley",
	southgard = "Village of Southgard",
	southhigh = "Great Southern Highway",
	southice = "Southern Icewynd Mountains",
	southmount = "Southern Mountains",
	southpass = "Southern Passages",
	spectre = "Spectre Isle",
	starsea = "Elemental Plane of Water, Starry Sea",
	stewartsville = "Village of Stewartsville",
	taerin = "Taerin Passages",
	talthos = "Village of Talthos",
	tarpits = "Tar Pit Wastes",
	taurus = "Astrosphere of Taurus",
	teethmount = "Avechna's Teeth",
	terentia_realm = "Blades of Justice",
	terentia_temple = "Temple of Terentia",
	thax_realm = "the Endless Redoubt",
	thax_temple = "Temple of Thax",
	tolborolla = "Tolborolla Valley",
	toronada = "Toronada Tidal Flats",
	tosha = "Tosha Monastery",
	treespirit = "Great Tree Spirit",
	tripleinn = "The Triple Junction Inn",
	tutotophet = "Tutotophet Hive",
	undersea = "Undersea of Keph",
	urlach = "Catacombs of the Dead",
	valtreth_realm = "The Salt Cliffs",
	valtreth_temple = "Temple of Valtreth",
	verasavir = "Verasavir Valley",
	viravain_realm = "Web of Darkness",
	viravain_temple = "Temple of Viravain",
	virgo = "Astrosphere of Virgo",
	vortex = "Cosmic Plane of the Vortex",
	wastestore = "the Waste Storage Facility",
	weiwae = "Temple of Weiwae",
	weiwae_realm = "Realm of Weiwae",
	wydyr = "Wydyr Glade",
	wyrdenisle = "Wyrden Isle",
	xion = "Workshop of Xion",
	zoaka = "Mount Zoaka",
	zvoltz_realm = "the City of Spires",
	zvoltz_temple = "the Temple of Zvoltz"
}